111111111111111111111111
11QD00000111000000010111
1D11111011D10011110001D1
100000000100001111000101
1101D1010000100000001001
1111111000D0001100000001
110000000010001110011001
11011100001D001110011001
110110000011001111000001
1101001111100000001000N1
11D10011111D000000010011
111111111111111111111111
