NO textures/wall.xpm
SO textures/wall.xpm
EA textures/wall.xpm
WE textures/wall.xpm

C 100,100,100
F 0,0,0

1111111111111111111111Q1111111111
1S00000000000000000001D1000000001
100000000000000000000101000000001
1101011111111111011111010000011DQ
11010111000000D100111100011111111
10010000001111110011111100D000001
101111110011111110111111011111101
100000000011111110111111000001111
100000000000000D10000000000000001
1D1111111111111011111111001111101
101111110000000011111110011111101
10001111D111111010000000000000D01
100000000000000000101111111111111
111111101111111111110000000000001
100000000000000000000000000111111
101111101110000000000000000111111
1001111D11110000011111111100000D1
1111111Q1111111111111111111111111
