NO ./textures/north.xpm
SO ./textures/north.xpm
WE ./textures/north.xpm
EA ./textures/north.xpm

11111111111111
100000D1111111
11110000000001
1000000S000011
111D11000000DQ
10000D00000001
11111111111111
