NO ./textures/north.xpm
SO ./textures/south.xpm
WE ./textures/west.xpm
EA ./textures/east.xpm

11111111111111
10000000000001
10000000000001
10000000000001
10000000000001
10000000000001
10000000000001
10000000000001
100000000000W1
11111111111111
