NO ./textures/north.xpm
SO ./textures/north.xpm
WE ./textures/north.xpm
EA ./textures/north.xpm

1111111111111
1S00000000001
1000000000001
1000000000001
1000000000001
1000000000001
1000000000001
1000000000001
1000000000001
1000000000001
1000000000001
1000000000001
1000000000001
1000000000001
1000000000001
1000000000001
1000000000001
1000000000001
1000000000001
1000000000001
1111111111111
