NO ./textures/north.xpm
SO ./textures/south.xpm
WE ./textures/west.xpm
EA ./textures/east.xpm
C 255,255,255

11111111111111
100000D1111111
11110000000001
1000000N000011
111D110000000Q
10000D00000001
11111111111111
