11111
10001
10101
10S01
11111
