11111111111111111
10000D00D00000001
10000D10101000001
1000001010D000001
10000110101000001
10000D00110000001
10000111100000001
10000000000000011
11111111111111111
