11111111111111111
10000000000000001
10000000000000001
10000000000000001
10000011100000001
1000000D000000001
10000001000000001
10000000000000011
11111111111111111
