1111111
1000001
1000001
100S001
1000001
100D001
1111111
