111111111
1S0000001
100000001
100000001
100000001
10D1Q0001
100000001
1D0000001
1Q1111111
