111111111
1S0000001
1Q0000001
100000001
100000001
10D1Q0001
100000001
100000001
111111111
