1111111
1N00001
1000001
1001001
1000001
1000001
1111111
