1111111
1000001
1000001
100N001
1000001
100D001
1111111
