1111111
100S001
1000001
100D001
111Q111
1111111
